Ball State	@ Buffalo
Western Michigan	@ Bowling Green
Central Michigan	@ Toledo
Kent State	@ Miami (OH)
Akron	@ Northern Illinois
Eastern Michigan	@ Ohio
East Carolina	@ Tulsa
Wyoming	@ Colorado State
North Texas	@ UTSA
UCLA	@ Washington
Houston	@ Arizona
2Ohio State	@ Northwestern
5Texas	@ Arkansas
23Clemson	@ 18Pittsburgh
Utah	@ 20Colorado
Liberty	@ Massachusetts
Louisiana Tech	@ Western Kentucky
Tulane	@ Navy
UL Monroe	@ Auburn
Coastal Carolina	@ Marshall
Murray State	@ Kentucky
Mercer	@ 11Alabama
Florida International	@ Jacksonville State
Florida Atlantic	@ Temple
Michigan State	@ Illinois
Syracuse	@ California
Sam Houston	@ Kennesaw State
Hawai'i	@ Utah State
6Penn State	@ Purdue
Virginia	@ 10Notre Dame
Boston College	@ 13SMU
15LSU	@ Florida
22Louisville	@ Stanford
Oregon State	@ Air Force
South Florida	@ Charlotte
Nebraska	@ USC
Baylor	@ West Virginia
Troy	@ Georgia Southern
James Madison	@ Old Dominion
24Missouri	@ South Carolina
Arkansas State	@ Georgia State
Rutgers	@ Maryland
12Boise State	@ San Jos√© State
Arizona State	@ 19Kansas State
South Alabama	@ Louisiana
Southern Miss	@ Texas State
1Oregon	@ Wisconsin
7Tennessee	@ 3Georgia
New Mexico State	@ 14Texas A&M
Cincinnati	@ 17Iowa State
Wake Forest	@ North Carolina
UAB	@ Memphis
21Washington State	@ New Mexico
Kansas	@ 9BYU
San Diego State	@ UNLV